111111111111
100000000001
100000000001
1P0000E00001
1C0000000001
111111111111